######################################################
#````````````````````````````````````````````````````#
#````````````````````````````````````````````````````#
#``````````````@``````````````````````````````########
#```````````````````````````````````````````````######
#```````````````````````````````````````##############
#````````````````````````````````````````````````````#
#``````````````````````~~~~~~~~~~````````````````````#
#``````````````~~~~~~~~~~~~~~~~~~~```````````````````#
#``````````````~~~~~~~~~~~~~~~~~~~```````````````````#
#``````````````~~~~~~~~~~~~~~~~~~~```````````^^^^^^^^^
#``````````````````````````########````````````````^^^
#``````````````````````````````^^^^^^^```````````````#
#````````````````^^^^``````````````^^^^^^^^^^^^``````#
##########````^^^^^^^^^^^^^^````````^^^^^^^``````````#
###``````#######^^^^^^^^^^^^^^^^^^^^^^^^^^```````````#
#```````````````````````````````````^^^^^^^^^^^^`````#
#```````````````````````````````````````########``####
####```#####``^^`````````````````````######```````####
##````````###^^^````````````~~~~```````````````7```###
#```````````##^^^`````````~~~~~~~``````````````@`````#
#````````````^^^^``````````~~~~`````````###`````````##
#``````````^^^^^^`````````````````````###`````````####
#########^^^^^^^^^^###################################