################~~~~~~~~~~~~##########################################^^^^^^^^^^^^^^^^^^^^^^^^^^^§§§^^^^^^^^
##``````###``~~~~~~~~~~~~~~~`````````````````````^^^^##```````````````^^^^^^^^^^^^§§```````````````§§^^^^^^^
#`````````#````~~~~~~~~~~~```````^^^^^^^^````````````##````````````````^^^^^^§````````````````````````````^^
#``*``````#````````````````````^^^^```````````#########````````````````^^^^^^``````````§§§§§§§`````````````^
##```####```````````````````^^^^^^``````````````#######````````````````^^§§^^`````````§§§§§§§§§§```````````^
######````````````````````````######````#############```````````````````^^^§§^```````````§§§§§````````````^^
#``````````````````````````````###```````````````##``````````````````````^^^^^^````````````````````````^^^^^
#`````~~```````````````~~~~~~~~~~`````````````````!```````````````````````^^^^^^``````````````````````^^^^^^
#````~~~~``````~~~~~~~~~~~~~~~~~~~````````````````$``````````````````````````^^^^^^^^^^^^^``````^^^```§§^^^^
#``````````````~~~~~~~~~~~~~~~~~~~``````````````^^^^``````````````````````````````^^^^^^^^^^^^^^^^^```^^^^^^
#``````````````~~~~~~~~~~~~~~~~~~~```````````^^^^^^^^^#``````````````````````````````````^^^^^^^^``````````#
#```````````````````````````########~~~~~~~~~~~~~~~^^^###````````````````````````````````^^^^^^^^``````````#
#`````````````````````````````````^^^^~~~~~~~~~~~~~~~######````````````````````````````^^^^^^^^````````````#
#````````````````^^^^``````````````^^^^^^^^^^^^~~~~~~~~~~####````````````````````````^^^^^^^^^^^^^`````````#
##########````^^^^^^^^^^````````````^^^^^^^~~~~~~~~~~~~~~~~##`````````````````````````^^^^^^^^^````````````#
###``````#######^^^^^^^^^^^`````````^^^^^^`````~~~~~~~~~~``````````````````````````````````````````````````#
#```````````````````````^^^^^^^```^^^^^^^^^^^^^^~~~~~~~````````````````````````````````````````````````````#
#```````````````````````````````````````###############```````````````^^^^````````````````````````````````##
#####``#####``^^`````````````````````######```````#####`````````````^^^^^^^^``````````````````````````````##
##````````###^^^````````````~~~~```````````````7```#####`````````^^^^^^^^^^^^^````````````````````````````##
#```````````##^^^`````````~~~~~~~````````````````````###``````^^^^^^^^^^^^^^````````^^^^^^``````````````####
#````````````^^^^``````````~~~~`````````###`````````######``````^^^^^^^^^`````````````^^^^^^`````````#######
######`````^^^^^^`````````````````````###`````````##########```````````````````^^^^^^^^^^^^^^`````##########
#########^^^^^^^^^^############################################^^^^^^^^^^^^^^^^^^^^^^^^^^^^^^^############## 