################~~~~~~~~~~~~##########################################^^^^^^^^^^^^^^^^^^^^^^^^^^^^^^^^^^^^^^
##``````###``~~~~~~~~~~~~~~~`````````````````````^^^^##```````````````^^^^^^^^^^^^§§```````````````§§^^^^^^^
#`````````#````~~~~~~~~~~~```````^^^^^^^^````````````##````````````````^^^^^^§````````````````````````````^^
#``*``````#````````````````````^^^^```````````#########````````````````^^^^^^``````````````````````````````^
##```####```````````````````^^^^^^``````````````#######````````````````^^§§^^``````````````````````````````^
######````````````````````````######````#############```````````````````^^^§§^````````````````````````````^^
#``````````````````````````````###```````````````##``````````````````````^^^^^^````````````````````````^^^^^
#`````~~```````````````~~~~~~~~~~`````````````````````````````````````````^^^^^^``````````````````````^^^^^^
#````~~~~``````~~~~~~~~~~~~~~~~~~~`````````````````````````````````````````^^^^^^^^^^^^^^^``````^^^§§§^^^^^^
#``````````````~~~~~~~~~~~~~~~~~~~``````````````^^^^`````````````````````````^^^^^^^^^^^^^^^^^^^^^^```^^^^^^
#``````````````~~~~~~~~~~~~~~~~~~~```````````^^^^^^^^^#```````````````````````````^^^^^^^^^^^^^^^`````^^^^^^
#```````````````````````````########~~~~~~~~~~~~~~~^^^###``````````````````````````````^^^^^^^^^^``````````#
#`````````````````````````````````^^^^~~~~~~~~~~~~~~~######````````````````````````````^^^^^^^^````````````#
#````````````````^^^^``````````````^^^^^^^^^^^^~~~~~~~~~~####````````````````````````^^^^^^^^^^^^^`````````#
##########````^^^^^^^^^^````````````^^^^^^^~~~~~~~~~~~~~~~~##`````````````````````````^^^^^^^^^````````````#
###``````#######^^^^^^^^^^^`````````^^^^^^`````~~~~~~~~~~``````````````````````````````````````````````````#
#```````````````````````^^^^^^^```^^^^^^^^^^^^^^~~~~~~~````````````````````````````````````````````````````#
#```````````````````````````````````````###############```````````````^^^^````````````````````````````````##
#####``#####``^^`````````````````````######```````#####`````````````^^^^^^^^``````````````````````````````##
##````````###^^^````````````~~~~```````````````````#####`````````^^^^^^^^^^^^^````````````````````````````##
#```````````##^^^`````````~~~~~~~````````````````````###``````^^^^^^^^^^^^^^````````^^^^^^``````````````####
#````````````^^^^``````````~~~~`````````###`````````######``````^^^^^^^^^`````````````^^^^^^`````````#######
######`````^^^^^^`````````````````````###`````````##########```````````````````^^^^^^^^^^^^^^`````##########
#########^^^^^^^^^^############################################^^^^^^^^^^^^^^^^^^^^^^^^^^^^^^^############## 