######################################################
#````````````````````````````````````````````````````#
#````````````````````````````````````````````````````#
#``````````````@``````````````````````````````########
#```````````````````````````````````````````````######
#```````````````````````````````````````##############
#````````````````````````````````````````````````````#
#``````````````````````~~~~~~~~~~````````````````````#
#``````````````~~~~~~~~~~~~~~~~~~~```````````````````#
#``````````````~~~~~~~~~~~~~~~~~~~```````````````````#
#``````````````~~~~~~~~~~~~~~~~~~~```````````^^^^^^^^^
#``````````````````````````########````````````````^^^
#``````````````````````````````^^^^^^^```````````````#
#````````````````^^^^``````````````^^^^^^^^^^^^``````#
##########````^^^^^^^^^^^^^^````````^^^^^^^````````@`#
###``````#######^^^^^^^^^^^^^^^^^^^^^^^^^^```````````#
#```````````````````````````````````^^^^^^^^^^^^`````#
#```````````````````````````````````````##############
####```#####``^^`````````````````````######```````####
##````````###^^^````````````~~~~```````````````````###
#```````````##^^^`````````~~~~~~~``````````````@`````#
#````````````^^^^``````````~~~~`````````###`````````##
#``````````^^^^^^`````````````````````###`````````####
#########^^^^^^^^^^###################################