################~~~~~~~~~~~~##########################
##``````###``~~~~~~~~~~~~~~~`````````````````````^^^^#
#`````````#````~~~~~~~~~~~```````^^^^^^^^````````````#
#``*``````#````@```````````````^^^^```````````########
##```####```````````````````^^^^^^``````````````######
######````````````````````````######````##############
#``````````````````````````````###```````````````````#
#`````~~```````````````~~~~~~~~~~````````````````````#
#````~~~~``````~~~~~~~~~~~~~~~~~~~```````````````````#
#```~~~~~~~````~~~~~~~~~~~~~~~~~~~```````````````````#
#```~~~~~~~````~~~~~~~~~~~~~~~~~~~```````````^^^^^^^^^
#``````~~~~`````````````````########```````````````^^^
#`````````````````````````````````^^^^```````````````#
#````````````````^^^^``````````````^^^^^^^^^^^^``````#
##########````^^^^^^^^^^````````````^^^^^^^``````````#
###``````#######^^^^^^^^^^^`````````^^^^^^```````````#
#```````````````````````^^^^^^^^^^^^^^^^^^^^^^^^`````#
#```````````````````````````````````````########``####
#####``#####``^^`````````````````````######```````####
##````````###^^^````````````~~~~```````````````7```###
#```````````##^^^`````````~~~~~~~````````````````````#
#````````````^^^^``````````~~~~`````````###````@````##
######`````^^^^^^`````````````````````###`````````####
#########^^^^^^^^^^###################################