```````````````````````````^^`````````````````````````
``````````````````````````````````````````````````````
``````````````````````````````````````````````````````
```````````````@``````````````````````````````########
````````````````````````````````````````````````######
````````````````````````````````````````##############
``````````````````````````````````````````````````````
```````````````````````~~~~~~~~~~`````````````````````
```````````````~~~~~~~~~~~~~~~~~~~````````````````````
```````````````~~~~~~~~~~~~~~~~~~~````````````````````
```````````````~~~~~~~~~~~~~~~~~~~```````````^^^^^^^^^
```````````````````````````########````````````````^^^
```````````````````````````````^^^^^^^````````````````
```````````````````````````````````^^^^^^^^^^^^```````
````````````````````````````````````^^^^^^^````````@``
```````````````````````````````^^^^^^^^^^^````````````
````````````````````````````````````^^^^^^^^^^^^``````
````````````````````````````````````````##############
``````````````^^`````````````````````######```````####
``````````###^^^```````````````````````````````````###
````````````##^^^``````````````````````````````@`````#
`````````````^^^^```````````````````````###`````````##
```````````^^^^^^`````````````````````###`````````####
`````````^^^^^^^^^^`````````````````##################