######################################################
#````````````````````````````````````````````````````#
#````````````````````````````````````````````````````#
#``````````````@``````````````````````````````########
#```````````````````````````````````````````````######
#```````````````````````````````````````##############
#````````````````````````````````````````````````````#
#``````````````````````~~~~~~~~~~````````````````````#
#``````````````~~~~~~~~~~~~~~~~~~~```````````````````#
#``````````````~~~~~~~~~~~~~~~~~~~```````````````````#
#``````````````~~~~~~~~~~~~~~~~~~~```````````^^^^^^^^^
#``````````````````````````########````````````````^^^
#``````````````````````````````^^^^^^^```````````````#
#``````````````````````````````````^^^^^^^^^^^^``````#
#```````````````````````````````````^^^^^^^````````@`#
#``````````````````````````````^^^^^^^^^^^```````````#
#```````````````````````````````````^^^^^^^^^^^^`````#
#```````````````````````````````````````##############
#`````````````^^`````````````````````######```````####
#`````````###^^^```````````````````````````````````###
#```````````##^^^``````````````````````````````@`````#
#````````````^^^^```````````````````````###`````````##
#``````````^^^^^^`````````````````````###`````````####
#########^^^^^^^^^^###################################